addition : ek
arrangement : ayarlama, düzenleme
artificial : yapay
artificial intelligence : yapay zeka
assign : atamak
introduction : giriş
participate : katılmak
whole : tüm
hope : umut
mankind : insanlık
most : en
nowadays : bu günlerde
recent : son
consecutive : ardışık, birbirini izleyen
requirement : gereksinim, gereklilik
necessity : gereklilik
necessary : gerekli
desire : arzu, istek
request : talep, istek
then : daha sonra, o zaman, öyleyse
device : cihaz
prompt : çabuk
recommend : tavsiye
yet : henüz
shortcut : kısa yol
snippet : pasaj
built-in : yerleşik, halihazırda inşaa edilmiş
display : görüntülemek
separated : ayrık, ayrılmış
readable : okunabilir
so far : şimdiye kadar 

expression : ifade
phrase : ifade
compund : birleşik
meaningful : anlamlı 
convey : iletmek
delibrate : bile isteye, kasıtlı
informative : bilgilendirici
guideline : yönerge, ilke
mandatory : zorunlu
interact : etkileşime girmek
wrote : yazmak(geçmiş zaman)
comparison : karşılaştırma, kıyaslama

declare : ilan etmek, beyan etmek
previous : öncesi, geçmiş
mentioned : adı geçmiş, bahsedilmiş
include : dahil etmek, içermek
immutable : değişmez
immune : bağışık, etkilenmeyen
immunity : bağışıklık
mutable : değiştirilebilir
interpolation : interpolasyon, ara değer bulma
split: bölmek
otherwise : aksi takdirde
export : ihraç edilen, dışa aktarılan 
import : ithalat, içe aktarılan
insensitive : duyarsız
compensate : telafi etmek
lift : kaldırmak
patronize : patronluk taslamak
charity : hayır kurumu
jargon : argo, varoş konuşma
inclusively : kapsayıcı olarak
annual : yıllık
income : gelir
extract : çıkarmak
salary : indirim
per : başına
decision : karar
logic : mantık
exhaustive : ayrıntılı
destruct : yok etmek
boundless : sınırsız
